..#..##.#.#..#.H.#..
....#..#.#..#.#.#.##
##.###.#.##.#..#....
.#..#.......#....#.#
.......#.#....#..#.#
#.###.......#.#.#..#
......##.#..#.......
##..#..###..#.####..
##..#..#.#.#...##...
H.#..##...#..#..#...