..#..##.#.#..#.H.#..
#####..#.#..#.#.#.##
##.###.#.##.#..#..##
.#..#..##H#.#....#.#
..######.#....#..#.#
#.###...###.#.#.#..#
......##.#..#..#####
##..#..###..#.####..
##..#..#.#.#...#####
H.#..##.###..#####..