.##.####....######.H
..###....##...H###..
...###....##..######
#..##..#....##..#...
.....####.......####
###........###.....#
#.###..#.##.##..#...
##.###........###...
..###H...##....###..
H...####....####.#..